IG_C_gene	mRNA
IG_C_pseudogene	Pseudogene
IG_D_gene	mRNA
IG_J_gene	mRNA
IG_J_pseudogene	Pseudogene
IG_pseudogene	Pseudogene
IG_V_gene	mRNA
IG_V_pseudogene	Pseudogene
lncRNA	Other non-coding RNA
miRNA	Other non-coding RNA
misc_RNA	Other non-coding RNA
Mt_rRNA	Mitochondrial rRNA
Mt_tRNA	Mitochondrial tRNA
polymorphic_pseudogene	Pseudogene
processed_pseudogene	Pseudogene
protein_coding	mRNA
pseudogene	Pseudogene
ribozyme	Other non-coding RNA
rRNA	rRNA
rRNA_pseudogene	Pseudogene
scaRNA	Other non-coding RNA
scRNA	Other non-coding RNA
snoRNA	Other non-coding RNA
snRNA	Other non-coding RNA
sRNA	Other non-coding RNA
TEC	mRNA
transcribed_processed_pseudogene	Pseudogene
transcribed_unitary_pseudogene	Pseudogene
transcribed_unprocessed_pseudogene	Pseudogene
translated_processed_pseudogene	Pseudogene
translated_unprocessed_pseudogene	Pseudogene
TR_C_gene	mRNA
TR_D_gene	mRNA
TR_J_gene	mRNA
TR_J_pseudogene	Pseudogene
TR_V_gene	Pseudogene
TR_V_pseudogene	Pseudogene
unitary_pseudogene	Pseudogene
unprocessed_pseudogene	Pseudogene
vaultRNA	Other non-coding RNA

Mt_rRNA	Mitochondrial rRNA
Mt_tRNA	Mitochondrial tRNA
Mt_IG_C_gene	Mitochondrial mRNA
Mt_IG_C_pseudogene	Mitochondrial Pseudogene
Mt_IG_D_gene	Mitochondrial mRNA
Mt_IG_J_gene	Mitochondrial mRNA
Mt_IG_J_pseudogene	Mitochondrial Pseudogene
Mt_IG_pseudogene	Mitochondrial Pseudogene
Mt_IG_V_gene	Mitochondrial mRNA
Mt_IG_V_pseudogene	Mitochondrial Pseudogene
Mt_lncRNA	Mitochondrial Other non-coding RNA
Mt_miRNA	Mitochondrial Other non-coding RNA
Mt_misc_RNA	Mitochondrial Other non-coding RNA
Mt_polymorphic_pseudogene	Mitochondrial Pseudogene
Mt_processed_pseudogene	Mitochondrial Pseudogene
Mt_protein_coding	Mitochondrial mRNA
Mt_pseudogene	Mitochondrial Pseudogene
Mt_ribozyme	Mitochondrial Other non-coding RNA
Mt_rRNA	Mitochondrial rRNA
Mt_rRNA_pseudogene	Mitochondrial Pseudogene
Mt_scaRNA	Mitochondrial Other non-coding RNA
Mt_scRNA	Mitochondrial Other non-coding RNA
Mt_snoRNA	Mitochondrial Other non-coding RNA
Mt_snRNA	Mitochondrial Other non-coding RNA
Mt_sRNA	Mitochondrial Other non-coding RNA
Mt_TEC	Mitochondrial mRNA
Mt_transcribed_processed_pseudogene	Mitochondrial Pseudogene
Mt_transcribed_unitary_pseudogene	Mitochondrial Pseudogene
Mt_transcribed_unprocessed_pseudogene	Mitochondrial Pseudogene
Mt_translated_processed_pseudogene	Mitochondrial Pseudogene
Mt_translated_unprocessed_pseudogene	Mitochondrial Pseudogene
Mt_TR_C_gene	Mitochondrial mRNA
Mt_TR_D_gene	Mitochondrial mRNA
Mt_TR_J_gene	Mitochondrial mRNA
Mt_TR_J_pseudogene	Mitochondrial Pseudogene
Mt_TR_V_gene	Mitochondrial Pseudogene
Mt_TR_V_pseudogene	Mitochondrial Pseudogene
Mt_unitary_pseudogene	Mitochondrial Pseudogene
Mt_unprocessed_pseudogene	Mitochondrial Pseudogene
Mt_vaultRNA	Mitochondrial Other non-coding RNA


